# MAX_NUM_STEP 40
@@@@@@I@
@......@
E.@....@
E...E..@
E.@...@@
E...E..@
@......@
@BB@@@@@