# MAX_NUM_STEP 40
@@@@@@@@
@......@
@.@....@
@...@..@
@.@...@@
@...@..@
@......@
@BB@@@@@